--------------------------------------------------------
-                          --                          -
- *   *  *  *  *  *  *  *  -- *  *  *  *  *  *  *   *  -
-                          --                          -
-                          --                          -
-    ------    --------    --    --------    ------    -
-    ------    --------    --    --------    ------    -
-  * ------ *  -------- *  --  * --------  * ------ *  -
-    ------    --------    --    --------    ------    -
-                                                      -
-  *  *  *  *  *  *  *  *  *  *  *  *  *  *  *  *   *  -
-                                                      -
-                                                      -
-  * ------ *  --  * --------------    --  * ------    -
-    ------    --    --------------    --    ------    -
-              --          --          --              -
-  *  *  *  *  --  *  *  * -- *  *  *  --  *  *  *  *  -
-              --          --          --              -
-              --          --          --              -
----------- *  --------    --    --------  * -----------
          -    --------    --    --------    -          .
          -    --                      --    -          .
          - *  --                      --  * -          .
          -    --                      --    -          .
          -    --                      --    -          .
          - *  --    -----    -----    --  * -          .
-----------    --    -            -    --    -----------
                     -            -                     .
  *   *  *  *  *  *  -            -  *  *  *  *  *   *  .
                     -            -                     .
                     -            -                     .
-----------  * --    -            -    --  * -----------
          -    --    --------------    --    -          .
          -    --                      --    -          .
          -  * --                      --  * -          .
          -    --                      --    -          .
          -    --                      --    -          .
          -  * --    --------------    --  * -          .
-----------    --    --------------    --    -----------
-                          --                          -
- *   *  *  *  *  *  *  *  --  *  *  *  *  *  *  *   * -
-                          --                          -
-                          --                          -
- *  ------    --------  * --  * --------  * ------  * -
-    ------    --------    --    --------    ------    -
-        --                                  --        -
-  *   * --  *  *  *  *  *  *  *  *  *  *  * -- *   *  -
-        --                                  --        -
-        --                                  --        -
-----  * --  * --  * --------------  * --  * -- *  -----
-----    --    --    --------------    --    --    -----
-              --          --          --              -
-  *  *  *  *  --  *  *  * -- *  *  *  --  *    *   *  -
-              --          --          --              -
-              --          --          --              -
-  * ------------------  * -- *  ------------------ *  -
-    ------------------    --    ------------------    -
-                                                      -
-  *  *  *  *  *  *     *  *  *  *  *  *  *  *  *   *  -
-                    *                                 -
-                                                      -
--------------------------------------------------------