--------------------------------------------------------
-                          --                          -
-                          --                          -
-                          --                          -
-                          --                          -
-    ------    --------    --    --------    ------    -
-    ------    --------    --    --------    ------    -
-    ------    --------    --    --------    ------    -
-    ------    --------    --    --------    ------    -
-                                                      -
-                                                      -
-                                                      -
-                                                      -
-    ------    --    --------------    --    ------    -
-    ------    --    --------------    --    ------    -
-              --          --          --              -
-              --          --          --              -
-              --          --          --              -
-              --          --          --              -
-----------    --------    --    --------    -----------
          -    --------    --    --------    -
          -    --                      --    -
          -    --                      --    -
          -    --                      --    -
          -    --                      --    -
          -    --    -----    -----    --    -
-----------    --    -            -    --    -----------
                     -            -
                     -            -
                     -            -
                     -            -
-----------    --    -            -    --    -----------
          -    --    --------------    --    -
          -    --                      --    -
          -    --                      --    -
          -    --                      --    -
          -    --                      --    -
          -    --    --------------    --    -
-----------    --    --------------    --    -----------
-                          --                          -
-                          --                          -
-                          --                          -
-                          --                          -
-    ------    --------    --    --------    ------    -
-    ------    --------    --    --------    ------    -
-        --                                  --        -
-        --                                  --        -
-        --                                  --        -
-        --                                  --        -
-----    --    --    --------------    --    --    -----
-----    --    --    --------------    --    --    -----
-              --          --          --              -
-              --          --          --              -
-              --          --          --              -
-              --          --          --              -
-    ------------------    --    ------------------    -
-    ------------------    --    ------------------    -
-                                                      -
-                                                      -
-                                                      -
-                                                      -
--------------------------------------------------------