--------------------------------------------------------
-                          --                          -
-                          --                          -
-                          --                          -
-                          --                          -
-    ------    --------    --    --------    ------    -
-    ------    --------    --    --------    ------    -
-    ------    --------    --    --------    ------    -
-    ------    --------    --    --------    ------    -
-                                                      -
-                                                      -
-                                                      -
-                                                      -
-    ------    --    --------------    --    ------    -
-    ------    --    --------------    --    ------    -
-              --          --          --              -
-              --          --          --              -
-              --          --          --              -
-              --          --          --              -
-----------    --------    --    --------    -----------
          -    --------    --    --------    -          .
          -    --                      --    -          .
          -    --                      --    -          .
          -    --                      --    -          .
          -    --                      --    -          .
          -    --    -----    -----    --    -          .
-----------    --    -            -    --    -----------
                     -            -                     .
                     -            -                     .
                     -            -                     .
                     -            -                     .
-----------    --    -            -    --    -----------
          -    --    --------------    --    -          .
          -    --                      --    -          .
          -    --                      --    -          .
          -    --                      --    -          .
          -    --                      --    -          .
          -    --    --------------    --    -          .
-----------    --    --------------    --    -----------
-                          --                          -
-                          --                          -
-                          --                          -
-                          --                          -
-    ------    --------    --    --------    ------    -
-    ------    --------    --    --------    ------    -
-        --                                  --        -
-        --                                  --        -
-        --                                  --        -
-        --                                  --        -
-----    --    --    --------------    --    --    -----
-----    --    --    --------------    --    --    -----
-              --          --          --              -
-              --          --          --              -
-              --          --          --              -
-              --          --          --              -
-    ------------------    --    ------------------    -
-    ------------------    --    ------------------    -
-                                                      -
-                                                      -
-                                                      -
-                                                      -
--------------------------------------------------------