----------------------------
-************--************-
-*----*-----*--*-----*----*-
-+----*-----*--*-----*----+-
-*----*-----*--*-----*----*-
-**************************-
-*----*--*--------*--*----*-
-*----*--*--------*--*----*-
-******--****--****--******-
------*----- -- -----*------
     -*----- -- -----*-     .
     -*--          --*-     .
     -*-- ---  --- --*-     .
------*-- -      - --*------
      *   -      -   *      .
------*-- -      - --*------
     -*-- -------- --*-     .
     -*--          --*-     .
     -*-- -------- --*-     .
------*-- -------- --*------
-************--************-
-*----*-----*--*-----*----*-
-*----*-----*--*-----*----*-
-+**--*******  *******--**+-
---*--*--*--------*--*--*---
---*--*--*--------*--*--*---
-******--****--****--******-
-*----------*--*----------*-
-*----------*--*----------*-
-**************************-
----------------------------