----------------------------
-************--************-
-*----*-----*--*-----*----*-
-+----*-----*--*-----*----+-
-*----*-----*--*-----*----*-
-**************************-
-*----*--*--------*--*----*-
-*----*--*--------*--*----*-
-******--****--****--******-
------*----- -- -----*------
.....-*----- -- -----*-.....
.....-*--          --*-.....
.....-*-- ---  --- --*-.....
------*-- -      - --*------
      *   -      -   *      ;
------*-- -      - --*------
.....-*-- -------- --*-.....
.....-*--          --*-.....
.....-*-- -------- --*-.....
------*-- -------- --*------
-************--************-
-*----*-----*--*-----*----*-
-*----*-----*--*-----*----*-
-+**--*******  *******--**+-
---*--*--*--------*--*--*---
---*--*--*--------*--*--*---
-******--****--****--******-
-*----------*--*----------*-
-*----------*--*----------*-
-**************************-
----------------------------